10 10 10 10 10 10 10 10 10 10 10 10 10 10 10 10 10 10 0 10
10 0 0 0 0 0 0 0 0 0 0 0 11 0 0 0 0 0 0 10
10 0 15 15 0 11 11 11 11 11 0 11 11 11 0 11 11 11 11 10
10 0 13 13 0 0 11 0 0 0 0 0 0 0 0 0 11 0 0 10
10 0 0 0 10 10 10 10 10 10 10 10 11 11 11 0 0 0 0 10
10 11 0 0 0 0 11 11 11 0 0 11 11 0 11 0 11 0 0 10
10 11 11 0 0 0 11 0 11 11 0 0 0 0 0 0 11 15 0 10
10 11 0 0 0 0 11 0 15 15 15 15 15 15 0 0 11 13 0 10
10 11 0 0 0 0 0 0 13 13 13 13 13 13 0 13 13 13 13 10
10 0 0 15 15 15 0 11 0 0 0 0 0 0 0 0 0 0 0 10
10 0 13 13 13 13 0 0 11 11 11 0 11 0 0 0 0 0 0 10
10 11 11 13 13 13 0 11 11 11 11 0 11 11 0 11 0 0 0 10
10 0 11 0 11 11 0 0 0 15 15 0 11 0 0 0 11 11 0 10
10 0 0 0 0 0 0 0 0 13 13 0 0 0 0 0 0 0 0 10
10 10 10 10 10 10 10 10 10 10 10 10 10 10 10 10 10 10 0 10