17 17 17 17 17 17 17 17 17 17 17 17 17 17 17 17 17 17 19 17
17 17 19 17 17 19 20 19 18 18 18 18 19 19 19 19 19 19 19 17
17 17 19 19 19 19 20 19 18 02 18 19 19 20 19 19 19 19 20 17
17 19 17 17 19 19 20 19 18 02 18 19 19 19 20 19 20 19 20 17
17 19 19 17 17 19 19 19 18 18 18 20 20 19 19 20 19 19 20 17
17 19 18 20 17 17 19 19 19 19 19 19 19 19 20 19 20 19 20 17
17 19 18 20 19 17 17 17 17 19 19 20 18 19 20 19 19 20 20 17
17 19 19 19 19 19 19 19 19 19 19 20 18 19 19 19 19 19 20 17
17 19 18 19 19 19 20 19 19 20 19 20 18 18 18 18 18 19 20 17
17 19 18 20 19 19 19 18 18 19 19 20 20 20 20 19 19 19 20 17
17 19 18 20 19 19 20 19 19 20 19 19 19 19 20 19 18 19 19 17
17 19 20 20 20 19 19 19 19 19 19 19 19 19 20 19 18 19 19 17
17 19 19 19 19 20 20 19 19 19 19 20 20 20 19 19 18 19 19 17
17 20 20 20 20 19 19 19 19 19 19 19 19 19 19 19 18 19 19 17
17 17 17 17 17 17 17 17 17 17 17 17 17 17 17 17 17 17 19 17