33 34 34 34 34 34 34 34 34 34 34 34 34 34 34 34 34 34 35 33
34 35 33 35 35 35 33 35 35 35 35 35 35 33 35 35 33 35 35 34
34 35 33 35 33 35 33 35 33 33 33 33 35 33 35 35 33 35 33 34
34 35 33 35 33 33 33 35 33 35 35 33 35 33 35 33 35 35 33 34
34 35 35 35 35 35 35 35 33 35 35 33 35 35 35 33 35 28 29 34
34 33 35 35 35 33 33 33 33 35 35 33 35 35 35 33 35 30 31 34
34 35 35 35 35 35 35 35 33 35 35 33 35 35 35 33 35 35 33 34
34 35 33 33 33 35 35 35 33 35 35 28 29 33 33 33 35 35 33 34
34 35 33 35 35 35 35 35 33 35 35 30 31 35 35 35 35 35 33 34
34 35 33 35 33 35 35 35 33 35 35 35 35 35 33 33 33 35 33 34
34 35 33 35 33 35 35 35 33 33 33 33 33 35 35 35 33 35 33 34
34 35 33 35 33 33 33 35 33 35 35 35 33 35 28 29 33 35 33 34
34 35 33 35 33 35 35 35 33 35 33 33 33 35 30 31 33 35 33 34
34 35 33 35 35 35 33 35 35 35 35 35 35 35 35 35 33 35 35 34
33 34 34 34 34 34 34 34 34 34 34 34 34 34 34 34 34 34 35 33