24 23 23 23 23 23 23 23 23 23 23 23 23 23 23 23 23 23 27 23
23 26 27 27 27 27 27 27 26 27 27 27 27 27 27 27 27 26 27 23
23 27 26 27 21 21 21 21 26 21 21 21 21 21 21 27 27 26 27 23
23 27 26 27 27 27 27 27 26 27 27 27 27 27 27 27 26 27 27 23
23 27 27 27 26 26 26 27 26 27 26 26 26 26 26 26 26 27 26 23
23 27 26 27 27 26 26 27 26 27 21 21 21 21 21 26 26 27 26 23
23 27 27 26 27 26 26 27 26 27 27 27 27 27 27 27 27 27 26 23 
23 27 26 26 26 27 26 27 26 26 26 26 26 26 26 26 26 27 27 23
23 27 27 26 26 27 27 27 26 26 27 27 27 27 27 27 27 26 27 23
23 26 27 26 26 26 26 26 26 26 26 27 21 21 21 26 27 27 27 23
23 26 27 27 27 27 27 26 21 21 27 27 26 21 21 21 27 27 27 23
23 26 27 26 26 26 26 26 26 26 26 27 26 26 26 26 26 26 27 23
23 27 27 27 27 27 27 27 26 21 21 27 27 21 21 26 26 26 26 23
23 27 26 26 26 26 26 27 27 27 27 27 27 27 27 27 27 27 27 23
24 23 23 23 23 23 23 23 23 23 23 23 23 23 23 23 23 23 27 23